11111111111111111111111111111111111111111111
111111111111111111CCCCCCCC111111111111111111
1111111111111111CCCCCCCCCCCC1111111111111111
111111111111111CCCCCCCCCCCCCC111111111111111
111111111111111CCCCCCCCCCCCCC111111111111111
11111111111111110000000000001111111111111111
11111111111111110000000000001111111111111111
11111111111111110000000000001111111111111111
11111111111111110000000000001111111111111111
11111111111111110000000000001111111111111111
11111111111111110000000000001111111111111111
11111111111111110000000000001111111111111111
11111111111111110000000000001111111111111111
11111111111111110000000000001111111111111111
11111111111111110000000000001111111111111111
11111111111111110000000000001111111111111111
11111111111111110000000000001111111111111111
11111111111111110000000000001111111111111111
11111111111111110000000000001111111111111111
11111111111111110000000000001111111111111111
11111111111111110000000000001111111111111111
11111111000011110000000000001111000011111111
111111000000001100000B0000001100000000111111
111110000000000000K0000K00000000000000011111
11111000000000K0000K00K00000K000000000011111
1111100000000000K00000000K000000000000011111
11111000000000000000000000000000000000011111
11111100000000000000PCE000000000000001111111
11111110000000000000000000000000000001111111
11111111111111110000000000001111111111111111
11111111111111111111111111111111111111111111
