111111111111111111111111111111111111111111111111111111
1P00000000000000000000000000000000000000000000000000K1
1000000000000000000000C0000000000000000000000000000001
100001111111111111100011111111111111111111111111100001
10000100000000000C10001C00000000000000C100000000100001
100001000000000111100010000000000000000000000000100001
100001000111100000000011111111110001111100011000100001
10000100010C100000000000000000000001KE1000001000100001
100000000100000111100000000000011111001000001000000001
1000000001000001C000000011111111000000000B0000000000X1
1X000000010000010000010000000000001C0010000000000000X1
1X0000000100000111111111000000000011111000001000000001
1000010001C0000000000000000000000000000000001000100001
100001000111111111111111111110001111111111111000100001
100001000000000000000000000K10001000000000000000100001
100001000K0000000000000000000000000000000000000K100001
100001111111111111111111111110001111111111111111100001
100000000000000000000000000000000000000000000000000001
1K00000000000000000000000000C00000000000000000000000K1
111111111111111111111111111111111111111111111111111111
