11111111111111111
1C000000X000000C1
10001000E00010001
10001010101010001
1001C111C111C1001
1P0000000000000X1
1001C111C111C1001
10001010101010001
10001000000010001
1C0000000000000C1
11111111111111111