1111111111111111111111
1P000001111110000000X1
1E0000000C111C00000001
1110000000110000000001
1111110000000000000011
1111111111111111111111