11111111111111111111
1P000000C1C0000000X1
1E000001111100000001
11000000000000000011
11110000111000001111
111C000001000000C111
11111111111111111111