1111111111111111111111111111111
1000000000C000000000C0000000001
1P00000000100000000010000000001
1C000000011100010001110000000C1
11100001C0100011100010C10000111
111100110000100C001000011001111
1110000101011000001101010000111
1C0000000000000E0000000000000C1
1000000101011000001101010000001
111000110000100C001000011000111
11110001C0000011100000C10001111
111X0000001000010000100000X1111
1C0000000111000C0001110000000C1
1000000000C000000000C0000000001
1111111111111111111111111111111