1111111111111111111111111111111111111
1P0000000000000000K0000000000000000C1
1000011111100000001000000011111100001
100001C00000000001B10000000000C100001
1000000000000110000000110000000000001
100001K00010001000E00010001000K100001
1C000111111C0010000000100C111111000C1
1X0000000000000000K0000000000000000X1
1111111111111111111111111111111111111
