1111111111111111111111111111111
1000000000C0000K0000C00000000X1
1P000000001000000000100000000E1
1C000000011100010001110000000C1
111000010C10001110001C010000111
111100110000100C001000011001111
1110000101011000001101010000111
1C0011000000000B0000000001100C1
1K000001010110000011010100000K1
111000110000100C001000011000111
11110001C0000011100000C10001111
111X0000001000010000100000X1111
1C0000000111000C0001110000000C1
1K00000000C0000K0000C00000000K1
1111111111111111111111111111111