1111111111111111111111111111111111111111111111111
1P000000100000C00000000000000000000000X0000100C01
10011100000011001111100000C1111111111100000100011
100000011100110011C111111100000111111111110010001
10000C111000110010000001E0000000000000000000000C1
1001111000000000000000111111100000011100000000011
10000000000000C0000000000000000111C0000000X000011
1111111111111111111111111111111111111111111111111