1111111111111111111
10P00000C00000010C1
1000010000000001001
1000011110000000001
10000000C1E10000001
1000000011000000001
110000000B000000XC1
1000110000001111111
1000011111000000001
1C00000000X00000011
1111111111111111111
