11111111
1PCE00B1
10000001
1KKK0XX1
11111111