11111111
1PCE0001
10000001
1O0000O1
11111111