11111111
1PCE00U1
10000001
1O0U00O1
11111111