1111111111111111111111111111111111111111111111111
1P0000001X0000C0000000000000000000000000000100C01
100111000000110011111X0000C1111111111100000100011
100000011000110011C111111100000111111111110010001
10000C111000000011000001E00000X0000000000000000C1
1001111000X00000110000111111100000011100000000011
10000X00000001C0000000000000000111C00000000000X11
1111111111111111111111111111111111111111111111111