111111
10P001
10C001
10E001
10X001
100001
111111