111111
10P001
10CE01
10X0X1
111111