111111
10P001
10CE01
1000X1
111111