111111
1P0001
10CE01
1000X1
111111