1111111
10P0001
10EC001
10X0001
1111111