111111
10P001
10CE01
10X001
111111