1111111111
1P00011111
11CE110X11
1111111111