111111
1P0X01
10CE01
1X00X1
111111