111111
10P001
10CE01
100001
111111