1111111111111
1gg1w000000C1
100q011111001
1P///.11E0001
1111111111111