1111111111111
1C000000000C1
1000C11111001
1P0011E0000C1
1111111111111
