1111111111111
10000000010C1
1000000001001
1P00000X000E1
1111111111111