1111111111111
10010000010C1
1000011001001
1P001C0X000E1
1111111111111