1111111111111
10010000010C1
1001011001001
1P00010X000E1
1111111111111