1111111111111
10010000X00C1
1000011000001
1P0X11E0X0001
1111111111111