1111111111111111111
10P00000C00000010C1
1000010000000001001
1000011110000000X01
10000000C1E10000001
1000000011000000001
110000000B0000000C1
1000110000001111111
1X00011111000000001
1C00000000000000011
1111111111111111111
